111111111113111
422211122222111
113213123132113
111222122122125
111132112121321
111112112122121
111222112132123
113231132112121
111222222112221
111111311111311